                                                                          
                                                                          
   ###############                ####################                    
   #.............#                #..................#                    
   #.............#                #..................#                    
   #.............##################..................##################   
   #..................................................................#   
   #.............##################..................################.#   
   #.............#                #..................#              #.#   
   #.............#                #..................#              #.#   
   #.............#                #..................#              #.#   
   #.............#                #..................#              #.#   
   #.............#                #..................#              #.#   
   ######.########                #..................#              #.#   
        #.#                       #########.##########              #.#   
        #.#                               #.#                       #.#   
        #.#                               #.#                       #.#   
        #.#                               #.#                       #.#   
        #.#                               #.#                       #.#   
        #.#                               #.#                       #.#   
  #######.#######                         #.#                       #.#   
  #.............#                         #.#                       #.#   
  #.............#                         #.#                       #.#   
  #.............#                         #.#                       #.#   
  #.............#                         #.#                       #.#   
  #.............#                         #.#                       #.#   
  #.............#                         #.#                       #.#   
  #.............#        ##################.#                       #.#   
  #.............#        #..................#                       #.#   
  #.............#        #..................#                       #.#   
  #.............#        #..................#                       #.#   
  #.............#        #..................###############         #.#   
  #.............#        #................................#         #.#   
  #.............#        #................................#         #.#   
  #.............#        #................................#         #.#   
  #.............#        #................................#         #.#   
  ######.########        #................................#         #.#   
       #.#               #................................#         #.#   
       #.#               #................................#         #.#   
       #.#               #................................#         #.#   
       #.#               #................................#         #.#   
       #.#               #................................#         #.#   
       #.#               ##################################         #.#   
       #.#                                                          #.#   
       #.#                                                          #.#   
       #.#                                                          #.#   
       #.############################################################.#   
       #..............................................................#   
       ################################################################   
                                                                          
                                                                          